R 960 600

100111
100011
010111
100011
110O11
111111
