R 1500 1000

NO textures/mur_mario.xpm
EA textures/mur_mario.xpm
WE textures/mur_mario.xpm
SO textures/mur_mario.xpm

F 20,100,20
C textures/sky2.xpm

S textures/flower.xpm

1111111111111111
1000000110001001
1000000000001001
1000000000000001
1111111110111111
1000000010100001
1000000010100101
1001111110111101
1000000000000001
1011111111111111
1000000000000001
1011111110111001
1010000010001001
1010000011111111
1010000000010001
1000000000010001
1111111100010001
10000001000000011111
10111101111110000001
10110000000000000001
10110111111111111111
1010011100000001
1110000000000001
1000000020000001
100020000000N001
10000000000000011111
10000000000000000001
11111111111111111111
