
NO textures/mur_mario.xpm

EA textures/mur_mario.xpm

WE textures/mur_mario.xpm

SO textures/mur_mario.xpm

F 0 0 0

R 1000 750

C textures/sky2.xpm

S textures/flower.xpm

1111111111111111
1000000110101001
1000000000101001
1001111100001001
1000000100000001
1111111110111111
1000000010100001
1000000010100101
1001111110111101
1000000000000001
1011111111111111
1000000000000001
1011111110111001
1010000010001001
1010000011111111
1010020000010201
1000000000010001
1111111100010001
1111100101000001
1000000100000001
1011110111111001
1011000000000001
1011011111111111
1010011100000001
1110000000N00001
1000200000000001
1000000020000001
1000000000000001
1111111111111111
