# **************************************************************************** #
#                                                           LE - /             #
#                                                               /              #
#    map.cub                                          .::    .:/ .      .::    #
#                                                  +:+:+   +:    +:  +:+:+     #
#    By: mminet <mminet@student.le-101.fr>          +:+   +:    +:    +:+      #
#                                                  #+#   #+    #+    #+#       #
#    Created: 2020/01/21 01:32:51 by mminet       #+#   ##    ##    #+#        #
#    Updated: 2020/01/31 23:04:37 by mminet      ###    #+. /#+    ###.fr      #
#                                                          /                   #
#                                                         /                    #
# **************************************************************************** #

R 1000 750
NO textures/cat2.xpm
EA textures/cat.xpm
WE textures/cat.xpm
SO textures/cat2.xpm
F  50 50 255
C textures/sky2.xpm
S textures/monster.xpm

1 1 1 1 1 1 1 1 1 1 1 1 1 1 1 1 
1 0 0 0 0 0 0 1 0 0 0 0 1 0 E 1
1 0 0 0 0 0 0 0 0 0 0 0 1 0 0 1 
1 0 0 1 1 1 1 1 0 2 0 0 1 0 0 1
1 0 0 0 0 0 0 1 0 0 0 0 0 0 0 1
1 1 1 1 1 1 1 1 1 0 1 1 1 1 1 1
1 0 0 0 0 0 0 0 1 0 1 0 0 0 0 1
1 0 0 0 0 0 0 0 1 0 1 0 0 1 0 1
1 0 0 1 1 1 1 1 1 0 1 1 1 1 0 1
1 0 0 0 0 0 0 0 0 0 0 0 0 0 0 1
1 0 1 1 1 1 1 1 1 0 1 1 1 1 1 1 
1 0 0 0 0 0 0 0 0 0 0 0 0 0 0 1
1 0 1 1 1 1 1 1 1 0 1 1 1 0 0 1
1 0 1 0 0 0 0 0 1 0 0 0 1 0 0 1
1 0 1 0 0 0 0 0 1 1 1 1 1 1 1 1
1 0 1 0 0 0 0 0 0 0 0 0 0 0 0 1
1 0 0 0 0 0 0 0 0 0 0 0 0 0 0 1  
1 1 1 1 1 1 1 1 0 0 0 0 0 0 0 1  
1 1 1 1 1 0 0 1 0 1 0 0 0 0 0 1
1 0 0 0 0 0 0 1 0 0 0 0 0 0 0 1 
1 0 1 1 1 1 0 1 1 1 1 1 1 0 0 1 
1 0 1 1 0 0 0 0 0 0 0 0 0 0 0 1
1 0 1 1 0 1 1 1 1 1 1 1 1 1 1 1
1 0 1 0 0 0 0 0 0 0 0 2 2 2 2 1
1 1 1 0 0 0 0 0 0 0 0 2 2 2 2 1 
1 0 0 0 0 0 0 0 0 0 0 2 2 2 2 1
1 0 0 0 0 0 0 0 0 0 0 2 2 2 2 1
1 0 0 0 0 0 0 0 0 0 0 0 0 0 0 1
1 1 1 1 1 1 1 1 1 1 1 1 1 1 1 1
