NO textures/stone.xpm

EA textures/stone.xpm

WE textures/stone.xpm

SO textures/stone.xpm

F 50 50 50

R 1000 750

C textures/sky.xpm

S textures/barrel.xpm

1111111111111111
1000000110101001
1000000000101001
1001111102001001
1000000100000001
1111111110111111
1000000010100001
1000000010100101
1001111110111101
100000000S000001
1011111111111111
1000000000000001
1011111110111001
1010000010001001
1010000011111111
1010000000010001
1000000000010001
1111111100010001
1111100101000001
1000000100000001
1011110111111001
1011000000000001
1011011111111111
1010011100000001
1110012100000001
1000000000000001
1000000000000001
1000000000000001
1111111111111111
