NO textures/cat2.xpm
EA textures/cat.xpm
WE textures/cat.xpm
SO textures/cat2.xpm
F 190 202 205
R 1000 750
C 0 255 236
S textures/monster.xpm


1111111111111111
1000000112101001
1000000000101001
1001111100001001
100000010N000001
1111111110111111
1000000010100001
1000000010100101
1001111110111101
1000000000000001
1011111110111111
1000000000000001
1011111110111001
1010000010001001
1010000011111111
1010000000010001
1000000000010001
1111111100010001
1111100101000001
1000000100000001
1011110111111001
1011000000000001
1011011111111111
1010000000022221
1110000000022221
1000000000022221
1000000000022221
1000000000000001
1111111111111111
