R 1000 750

NO textures/wood.xpm
EA textures/redbrick.xpm
WE textures/redbrick.xpm
SO textures/wood.xpm

F 50 50 50
C textures/sky.xpm
S textures/barrel.xpm

11111
10001
12021
100N1
11111
