NO textures/stone.xpm

EA textures/stone.xpm

WE textures/stone.xpm

SO textures/stone.xpm

F 50 50 50

R 1000 750

C textures/sky.xpm

S textures/barrel.xpm

11111111
12222201
12222201
10000001
100N0001
11111111
